areaType,areaName,areaCode,date,newPillarOneTestsByPublishDate,newPillarTwoTestsByPublishDate,newPillarThreeTestsByPublishDate,newPillarFourTestsByPublishDate,newTestsByPublishDate,cumPillarOneTestsByPublishDate,cumPillarTwoTestsByPublishDate,cumPillarThreeTestsByPublishDate,cumPillarFourTestsByPublishDate,cumTestsByPublishDate
overview,United Kingdom,K02000001,2022-03-03,87250,562080,3370,17044,669744,54116491,412623202,4617877,13679725,485037295
overview,United Kingdom,K02000001,2022-03-02,84578,599334,3192,20173,707277,53938443,412025081,4614507,13662681,484240712
overview,United Kingdom,K02000001,2022-03-01,87178,549575,2664,13079,652496,53853866,411389829,4610447,13642508,483496650
overview,United Kingdom,K02000001,2022-02-28,77862,606461,1150,11791,697264,53766688,410803967,4607783,13593996,482772434
overview,United Kingdom,K02000001,2022-02-27,56142,463649,148,15016,534955,53688826,410149236,4606633,13582205,482026900
overview,United Kingdom,K02000001,2022-02-26,61371,417114,3022,16537,498044,53632684,409685587,4606485,13567110,481491866
overview,United Kingdom,K02000001,2022-02-25,72350,525997,4422,15244,618013,53571313,409268473,4603463,13550573,480993822
overview,United Kingdom,K02000001,2022-02-24,84502,585203,3881,16300,689886,53498963,408708412,4599041,13535329,480341745
overview,United Kingdom,K02000001,2022-02-23,82423,656439,4408,23055,766325,53359581,408083153,4595160,13519029,479556923
overview,United Kingdom,K02000001,2022-02-22,96823,623662,5707,15657,741849,53277158,407390458,4590317,13495974,478753907
overview,United Kingdom,K02000001,2022-02-21,86553,716966,2661,13602,819782,53180335,406724647,4584610,13480317,477969909
overview,United Kingdom,K02000001,2022-02-20,65801,624954,3496,13236,707487,53093782,405946452,4581949,13466715,477088898
overview,United Kingdom,K02000001,2022-02-19,68462,501188,1888,14724,586262,53027981,405285582,4578453,13453419,476345435
overview,United Kingdom,K02000001,2022-02-18,82577,595231,6220,23575,707603,52959519,404754695,4576565,13438695,475729474
overview,United Kingdom,K02000001,2022-02-17,86939,781679,6989,31900,907507,52876911,404114156,4570345,13415120,474976532
overview,United Kingdom,K02000001,2022-02-16,99658,850594,4507,26936,981695,52762744,403277150,4563356,13383220,473986470
overview,United Kingdom,K02000001,2022-02-15,105364,764500,2651,18802,891317,52663086,402378412,4558259,13356284,472956041
overview,United Kingdom,K02000001,2022-02-14,88882,788318,1129,12088,890417,52548723,401559996,4555608,13331738,471996065
overview,United Kingdom,K02000001,2022-02-13,72486,692343,867,19626,785322,52459841,400702358,4554479,13319650,471036328
overview,United Kingdom,K02000001,2022-02-12,75735,629872,6283,18626,730516,52387355,399965793,4553612,13300007,470206767
overview,United Kingdom,K02000001,2022-02-11,91325,810719,4536,18876,925456,52311620,399295144,4547329,13281381,469435474
overview,United Kingdom,K02000001,2022-02-10,91866,932544,6771,18897,1050078,52220295,398429200,4542793,13258307,468450595
overview,United Kingdom,K02000001,2022-02-09,105117,1048576,6153,18853,1178699,52111665,397424203,4529824,13239410,467305102
overview,United Kingdom,K02000001,2022-02-08,113049,949202,995,13194,1076440,52006548,396316527,2487278,13173989,463984342
overview,United Kingdom,K02000001,2022-02-07,88915,1026306,879,13392,1129492,51893499,395299499,2486283,13160795,462840076
overview,United Kingdom,K02000001,2022-02-06,79653,910309,385,16972,1007319,51804588,394177133,2485404,13097369,461564494
overview,United Kingdom,K02000001,2022-02-05,77872,758735,575,15385,852567,51724935,393209726,2485019,13080315,460499995
overview,United Kingdom,K02000001,2022-02-04,92698,953540,1462,16917,1064617,51647063,392401503,2484444,13064930,459597940
overview,United Kingdom,K02000001,2022-02-03,100091,1107357,1472,19345,1228265,51554365,391379713,2482982,13048013,458465073
overview,United Kingdom,K02000001,2022-02-02,104247,1215590,1023,19683,1340543,51418416,390185517,2481510,13028668,457114111
overview,United Kingdom,K02000001,2022-02-01,108598,1066124,982,12931,1188635,51314210,388901066,2480112,13008985,455704373
overview,United Kingdom,K02000001,2022-01-31,93160,1110459,931,15193,1219743,51205612,387756905,2479130,12996054,454437701
overview,United Kingdom,K02000001,2022-01-30,77694,1033776,266,16549,1128285,51057520,386563487,2478199,12980861,453080067
overview,United Kingdom,K02000001,2022-01-29,71858,849242,564,11821,933485,50979826,385418707,2477933,12964197,451840663
overview,United Kingdom,K02000001,2022-01-28,91060,1054783,1428,13975,1161246,50907967,384514183,2477369,12952376,450851895
overview,United Kingdom,K02000001,2022-01-27,93791,1176719,1402,17251,1289163,50816908,383385586,2475941,12878966,449557401
overview,United Kingdom,K02000001,2022-01-26,104130,1326345,1099,15589,1447163,50704634,382118211,2474539,12861715,448159099
overview,United Kingdom,K02000001,2022-01-25,115995,1146099,1188,13215,1276497,50600504,380717180,2473023,12846126,446636833
overview,United Kingdom,K02000001,2022-01-24,88502,1235575,986,12441,1337504,50484510,379488479,2471835,12832911,445277735
overview,United Kingdom,K02000001,2022-01-23,81043,1130268,403,17942,1229656,50396012,378139095,2470849,12820470,443826426
overview,United Kingdom,K02000001,2022-01-22,79628,940102,662,25030,1045422,50314969,376941192,2470446,12802488,442529095
overview,United Kingdom,K02000001,2022-01-21,96678,1110015,1314,13633,1221640,50232530,375942130,2469784,12777458,441421902
overview,United Kingdom,K02000001,2022-01-20,102452,1244950,1710,24409,1373521,50135851,374757302,2468470,12763825,440125448
overview,United Kingdom,K02000001,2022-01-19,114771,1402031,1261,24841,1542904,50009940,373416789,2466760,12739416,438632905
overview,United Kingdom,K02000001,2022-01-18,108340,1182494,1359,18702,1310895,49895193,371935691,2465305,12714575,437010764
overview,United Kingdom,K02000001,2022-01-17,96003,1254480,1082,14644,1366209,49786854,370654884,2463946,12652039,435557723
overview,United Kingdom,K02000001,2022-01-16,78398,1168969,419,27002,1274788,49690851,369282001,2462864,12637395,434073111
overview,United Kingdom,K02000001,2022-01-15,80020,975600,608,25719,1081947,49596292,368047249,2462445,12610373,432716359
overview,United Kingdom,K02000001,2022-01-14,100588,1130209,1615,30671,1263083,49516272,367014068,2461837,12584654,431576831
overview,United Kingdom,K02000001,2022-01-13,101191,1289342,1625,25078,1417236,49415702,365803733,2460222,12553983,430233640
overview,United Kingdom,K02000001,2022-01-12,116701,1434066,1440,29152,1581359,49292599,364402797,2458094,12528905,428682395
overview,United Kingdom,K02000001,2022-01-11,122589,1266712,1612,24711,1415624,49175962,362872102,2456074,12499753,427003891
overview,United Kingdom,K02000001,2022-01-10,92692,1488753,1353,38007,1620805,49053373,361481676,2454462,12475042,425464553
overview,United Kingdom,K02000001,2022-01-09,85361,1542298,506,30080,1658245,48960681,359828217,2453109,12392712,423634719
overview,United Kingdom,K02000001,2022-01-08,88877,1222795,831,15876,1328379,48875320,358214507,2452603,12362632,421905062
overview,United Kingdom,K02000001,2022-01-07,112002,1482292,1948,12298,1608540,48786443,356916123,2451772,12346756,420501094
overview,United Kingdom,K02000001,2022-01-06,123343,1687896,1777,10396,1823412,48674440,355249817,2449824,12334458,418708539
overview,United Kingdom,K02000001,2022-01-05,132356,1895658,2321,3739,2034074,48498592,353342378,2448047,12324062,416613079
overview,United Kingdom,K02000001,2022-01-04,122966,1922891,1552,5228,2052637,48366233,351274509,2442766,12320323,414403831
overview,United Kingdom,K02000001,2022-01-03,82086,1619953,487,1573,1704099,48237409,349257853,2441214,12258546,412195022
overview,United Kingdom,K02000001,2022-01-02,76086,1277394,569,19278,1373327,48155323,347564580,2440727,12256973,410417603
overview,United Kingdom,K02000001,2022-01-01,59742,959424,579,10490,1030235,48048807,346133790,2440158,12237695,408860450
overview,United Kingdom,K02000001,2021-12-31,82078,1571966,1301,15890,1671235,47989065,345107537,2439579,12227205,407763386
overview,United Kingdom,K02000001,2021-12-30,117509,1376632,1398,15023,1510562,47906987,343455822,2438278,12211315,406012402
overview,United Kingdom,K02000001,2021-12-29,105834,1391052,1186,3443,1501515,47749275,341999683,2436880,12196292,404382130
overview,United Kingdom,K02000001,2021-12-28,95935,1375971,457,4310,1476673,47643439,340537283,2435694,12192849,402809265
overview,United Kingdom,K02000001,2021-12-27,71188,1207561,616,1085,1280450,47547504,339096518,2435237,12188539,401267798
overview,United Kingdom,K02000001,2021-12-26,58869,1211356,369,7476,1278070,47476316,337816793,2434621,12187454,399915184
overview,United Kingdom,K02000001,2021-12-25,47787,1132062,409,17343,1197601,47417447,336521279,2434252,12179963,398552941
overview,United Kingdom,K02000001,2021-12-24,87822,1516684,1130,10259,1615895,47369660,335339918,2433843,12162620,397306041
overview,United Kingdom,K02000001,2021-12-23,94188,1517269,1250,14007,1626714,47281838,333754395,2432713,12152361,395621307
overview,United Kingdom,K02000001,2021-12-22,110920,1534709,1257,5336,1652222,47148783,332147253,2431073,12138354,393865463
overview,United Kingdom,K02000001,2021-12-21,117166,1362590,1304,11229,1492289,47037865,330535539,2429816,12133018,392136238
overview,United Kingdom,K02000001,2021-12-20,91640,1379773,1111,21658,1494182,46920698,329106837,2428512,12088610,390544657
overview,United Kingdom,K02000001,2021-12-19,78148,1375757,418,14597,1468920,46829057,327646788,2427401,12066952,388970198
overview,United Kingdom,K02000001,2021-12-18,76506,1321166,577,8889,1407138,46713530,326211769,2426983,12052279,387404561
overview,United Kingdom,K02000001,2021-12-17,96585,1468841,1408,12715,1579549,46637024,324833685,2426406,12043390,385940505
overview,United Kingdom,K02000001,2021-12-16,100110,1485389,1533,13459,1600491,46540439,323291378,2424998,12030675,384287490
overview,United Kingdom,K02000001,2021-12-15,116666,1513305,1413,8488,1639872,46417877,321716565,2423465,12017179,382575086
overview,United Kingdom,K02000001,2021-12-14,113615,1192663,1177,15857,1323312,46301211,320130439,2421325,12008691,380861666
overview,United Kingdom,K02000001,2021-12-13,89237,1203724,1027,21296,1315284,46187597,318872772,2420148,11970332,379450849
overview,United Kingdom,K02000001,2021-12-12,80986,1161521,412,16806,1259725,46098360,317578093,2419121,11949036,378044610
overview,United Kingdom,K02000001,2021-12-11,77002,920591,543,15199,1013335,46017374,316416572,2418709,11932204,376784859
overview,United Kingdom,K02000001,2021-12-10,97627,1083340,1560,20097,1202624,45940372,315452864,2418166,11917005,375728407
overview,United Kingdom,K02000001,2021-12-09,98946,1207490,1732,22145,1330313,45842749,314312635,2416606,11896908,374468898
overview,United Kingdom,K02000001,2021-12-08,110737,1148512,1194,20975,1281418,45720118,313028589,2414382,11874763,373037852
overview,United Kingdom,K02000001,2021-12-07,109717,921775,1497,21430,1054419,45609382,311818047,2412904,11853788,371694121
overview,United Kingdom,K02000001,2021-12-06,88236,1004849,897,29170,1123152,45489249,310839767,2411407,11800792,370541215
overview,United Kingdom,K02000001,2021-12-05,76621,1048465,260,14466,1139812,45401012,309750418,2410510,11771622,369333562
overview,United Kingdom,K02000001,2021-12-04,76190,771938,586,25322,874036,45324391,308662663,2410250,11757156,368154460
overview,United Kingdom,K02000001,2021-12-03,91811,944758,1533,18712,1056814,45248201,307856299,2409664,11701444,367215608
overview,United Kingdom,K02000001,2021-12-02,95071,1029613,1537,6036,1132257,45156387,306860965,2408131,11682732,366108215
overview,United Kingdom,K02000001,2021-12-01,106412,1077859,1474,3689,1189434,45029573,305762410,2406594,11676696,364875273
overview,United Kingdom,K02000001,2021-11-30,105445,889604,1068,7811,1003928,44923163,304637615,2404079,11673007,363637864
overview,United Kingdom,K02000001,2021-11-29,89458,909401,822,20776,1020457,44817757,303690987,2403011,11619293,362531048
overview,United Kingdom,K02000001,2021-11-28,73970,919722,258,25764,1019714,44728299,302699441,2402189,11598517,361428446
overview,United Kingdom,K02000001,2021-11-27,67137,642258,418,17667,727480,44654329,301746982,2401931,11572631,360375873
overview,United Kingdom,K02000001,2021-11-26,91374,776523,995,19687,888579,44587193,301074104,2401513,11554964,359617774
overview,United Kingdom,K02000001,2021-11-25,94508,937967,1253,18437,1052165,44495820,300251104,2400518,11535277,358682719
overview,United Kingdom,K02000001,2021-11-24,101537,974585,1283,9033,1086438,44372422,299248974,2399265,11516840,357537501
overview,United Kingdom,K02000001,2021-11-23,107670,792369,1121,12238,913398,44270554,298230754,2396914,11507807,356406029
overview,United Kingdom,K02000001,2021-11-22,88451,880376,1010,12136,981973,44131514,297388467,2395793,11453741,355369515
overview,United Kingdom,K02000001,2021-11-21,73236,913583,381,26194,1013394,44043066,296428886,2394783,11441605,354308340
overview,United Kingdom,K02000001,2021-11-20,74638,633833,547,13077,722095,43909284,295477735,2394402,11415349,353196770
overview,United Kingdom,K02000001,2021-11-19,94145,757533,1140,16265,869083,43834646,294815186,2393855,11402272,352445959
overview,United Kingdom,K02000001,2021-11-18,101029,879243,1215,14446,995933,43740499,294010425,2392715,11386007,351529646
overview,United Kingdom,K02000001,2021-11-17,105069,930242,1421,9902,1046634,43639469,293067062,2391500,11371561,350469592
overview,United Kingdom,K02000001,2021-11-16,97299,699924,1084,12385,810692,43476017,292009650,2389270,11361659,349236596
overview,United Kingdom,K02000001,2021-11-15,82368,823750,648,12385,919151,43378751,291259931,2388186,11335883,348362751
overview,United Kingdom,K02000001,2021-11-14,74725,829039,246,14780,918790,43296385,290357302,2387538,11323498,347364723
overview,United Kingdom,K02000001,2021-11-13,71481,580783,378,15527,668169,43221660,289499664,2387292,11308569,346417185
overview,United Kingdom,K02000001,2021-11-12,87177,728910,863,16566,833516,43150179,288887662,2386914,11293042,345717797
overview,United Kingdom,K02000001,2021-11-11,91726,868545,1285,22932,984488,43063003,288112185,2386051,11276476,344837715
overview,United Kingdom,K02000001,2021-11-10,109355,903800,1147,12875,1027177,42944079,287179565,2384766,11253544,343761954
overview,United Kingdom,K02000001,2021-11-09,112617,727133,1027,13344,854121,42834730,286237642,2382910,11240669,342695951
overview,United Kingdom,K02000001,2021-11-08,85941,824129,839,10715,921624,42722116,285460328,2381883,11227325,341791652
overview,United Kingdom,K02000001,2021-11-07,73305,777518,305,18193,869321,42636175,284554467,2381044,11216610,340788296
overview,United Kingdom,K02000001,2021-11-06,75430,561387,437,13173,650427,42558360,283738586,2380739,11198348,339876033
overview,United Kingdom,K02000001,2021-11-05,91638,719704,1277,22006,834625,42482928,283147783,2380302,11185175,339196188
overview,United Kingdom,K02000001,2021-11-04,77730,815909,1328,23451,918418,42391306,282376940,2379025,11163169,338310440
overview,United Kingdom,K02000001,2021-11-03,105573,881284,1339,35623,1023819,42282059,281495644,2374203,11139718,337291624
overview,United Kingdom,K02000001,2021-11-02,112179,741115,1362,17325,871981,42176487,280573843,2372864,11104095,336227289
overview,United Kingdom,K02000001,2021-11-01,78808,816190,953,12362,908313,42064401,279780351,2371502,11086770,335303024
overview,United Kingdom,K02000001,2021-10-31,69655,866869,429,14334,951287,41985593,278879477,2370549,11074408,334310027
overview,United Kingdom,K02000001,2021-10-30,72922,583950,503,21541,678916,41915938,277976369,2370120,11060031,333322458
overview,United Kingdom,K02000001,2021-10-29,85333,732453,1216,31054,850056,41843018,277359290,2369617,11038490,332610415
overview,United Kingdom,K02000001,2021-10-28,91955,759400,1466,25991,878812,41757686,276583623,2368401,11007436,331717146
overview,United Kingdom,K02000001,2021-10-27,107609,778316,997,31641,918563,41645823,275758293,2366935,10981445,330752496
overview,United Kingdom,K02000001,2021-10-26,99838,697209,1166,7179,805392,41538214,274942942,2365938,10949804,329796898
overview,United Kingdom,K02000001,2021-10-25,86011,713738,1046,22064,822859,41438376,274202168,2364772,10942625,328947941
overview,United Kingdom,K02000001,2021-10-24,65623,708745,199,11185,785752,41336134,273409408,2363726,10920561,328029829
overview,United Kingdom,K02000001,2021-10-23,75443,620624,446,10013,706526,41270516,272668936,2363527,10909281,327212260
overview,United Kingdom,K02000001,2021-10-22,91356,807495,1180,15876,915907,41195073,272016418,2363081,10899268,326473840
overview,United Kingdom,K02000001,2021-10-21,97671,895449,1210,19092,1013422,41103712,271161854,2361901,10883392,325510859
overview,United Kingdom,K02000001,2021-10-20,103612,984043,1345,17306,1106306,40962928,270200024,2360453,10864300,324387705
overview,United Kingdom,K02000001,2021-10-19,110565,766658,1105,942,879270,40859316,269170030,2358487,10846994,323234827
overview,United Kingdom,K02000001,2021-10-18,86393,825157,736,293,912579,40748751,268346138,2357382,10760599,322212870
overview,United Kingdom,K02000001,2021-10-17,73897,906631,216,0,980744,40662414,267436968,2356646,10732505,321188533
overview,United Kingdom,K02000001,2021-10-16,73321,655722,418,0,729461,40588517,266494926,2356430,10732204,320172077
overview,United Kingdom,K02000001,2021-10-15,91312,803065,1020,17187,912584,40515198,265805689,2356012,10732204,319409103
overview,United Kingdom,K02000001,2021-10-14,86381,894502,1357,1913,984153,40423884,264947024,2354992,10715017,318440917
overview,United Kingdom,K02000001,2021-10-13,105913,939245,1093,1927,1048178,40106131,263975289,2353635,10697615,317132670
overview,United Kingdom,K02000001,2021-10-12,107500,765998,799,1810,876107,40200220,262990036,2351571,10680440,316222267
overview,United Kingdom,K02000001,2021-10-11,86419,849869,752,725,937765,40092720,262167345,2350772,10667880,315278717
overview,United Kingdom,K02000001,2021-10-10,76071,892198,121,0,968390,40006301,261226831,2350020,10656632,314239784
overview,United Kingdom,K02000001,2021-10-09,72517,624020,553,12536,709626,39930230,260301055,2349899,10656530,313237714
overview,United Kingdom,K02000001,2021-10-08,97588,805878,1227,16015,920708,39857713,259647083,2349346,10643994,312498136
overview,United Kingdom,K02000001,2021-10-07,84503,863292,1328,16294,965417,39760125,258782848,2348119,10627979,311519071
overview,United Kingdom,K02000001,2021-10-06,104173,949278,1210,21183,1075844,39634333,257847380,2346791,10611685,310440189
overview,United Kingdom,K02000001,2021-10-05,105074,751342,1102,1095,858613,39530161,256843783,2345258,10584298,309303500
overview,United Kingdom,K02000001,2021-10-04,80038,860943,677,1520,943178,39425150,256035681,2344156,10571999,308376986
overview,United Kingdom,K02000001,2021-10-03,70791,936712,328,14567,1022398,39345112,255079964,2343479,10570479,307339034
overview,United Kingdom,K02000001,2021-10-02,81209,639662,530,14167,735568,39274321,254110751,2343151,10555779,306284002
overview,United Kingdom,K02000001,2021-10-01,84671,794376,1075,1035,881157,39193112,253484181,2342621,10541612,305561526
overview,United Kingdom,K02000001,2021-09-30,85645,939799,973,17592,1044009,39108441,252630437,2341546,10540577,304621001
overview,United Kingdom,K02000001,2021-09-29,109322,1001325,1182,6333,1118162,38973780,251611164,2340573,10522985,303448502
overview,United Kingdom,K02000001,2021-09-28,106760,751288,865,3830,862743,38865750,250562779,2337968,10506170,302272667
overview,United Kingdom,K02000001,2021-09-27,77869,919856,724,12534,1010983,38747349,249754105,2337103,10469096,301307653
overview,United Kingdom,K02000001,2021-09-26,77871,1027952,113,20617,1126553,38669483,248736702,2336379,10456562,300199126
overview,United Kingdom,K02000001,2021-09-25,81764,686016,161,18587,786528,38591073,247674379,2336266,10435850,299037568
overview,United Kingdom,K02000001,2021-09-24,84407,800363,611,22126,907507,38509850,246954293,2336105,10417263,298217511
overview,United Kingdom,K02000001,2021-09-23,94728,960399,1082,10300,1066509,38425443,246093787,2335494,10380456,297235180
overview,United Kingdom,K02000001,2021-09-22,110206,848724,606,12369,971905,38330715,244924964,2334412,10356077,295946168
overview,United Kingdom,K02000001,2021-09-21,115349,764740,794,17470,898353,38220509,244031202,2333806,10343708,294929225
overview,United Kingdom,K02000001,2021-09-20,88166,886399,651,9849,985065,38105161,243199498,2333012,10279915,293917586
overview,United Kingdom,K02000001,2021-09-19,62550,1053566,36,7682,1123834,38005705,242158642,2332361,10270066,292766774
overview,United Kingdom,K02000001,2021-09-18,70745,620583,82,23374,714784,37943155,241068488,2332325,10262285,291606253
overview,United Kingdom,K02000001,2021-09-17,92323,810751,342,28944,932360,37872415,240414095,2332243,10238911,290857664
overview,United Kingdom,K02000001,2021-09-16,103674,937918,537,19042,1061171,37780095,239538930,2331901,10209967,289860893
overview,United Kingdom,K02000001,2021-09-15,94008,969445,528,23054,1087035,37638275,238504143,2331364,10190925,288664707
overview,United Kingdom,K02000001,2021-09-14,107936,772358,445,3797,884536,37544267,237466931,2329421,10157722,287498341
overview,United Kingdom,K02000001,2021-09-13,83885,944413,281,16180,1044759,37436331,236597846,2328976,10130311,286493464
overview,United Kingdom,K02000001,2021-09-12,76352,991059,206,11785,1079402,37352446,235501938,2328695,10114131,285297210
overview,United Kingdom,K02000001,2021-09-11,74323,658634,296,14703,747956,37276094,234464711,2328489,10102262,284171556
overview,United Kingdom,K02000001,2021-09-10,89197,977099,619,2418,1069333,37201771,233734989,2328193,10087559,283352512
overview,United Kingdom,K02000001,2021-09-09,95570,1133217,832,14442,1244061,37112577,232616539,2327574,10085141,282141831
overview,United Kingdom,K02000001,2021-09-08,104919,1135468,555,16054,1256996,36996808,231331552,2326742,10070699,280725801
overview,United Kingdom,K02000001,2021-09-07,112251,1031635,668,28975,1173529,36891890,230038793,2324473,10054645,279309801
overview,United Kingdom,K02000001,2021-09-06,86391,1249094,504,12738,1348727,36779640,228849481,2323805,9998589,277951515
overview,United Kingdom,K02000001,2021-09-05,76016,955638,196,7140,1038990,36693249,227464012,2323301,9985851,276466413
overview,United Kingdom,K02000001,2021-09-04,79487,666494,334,12989,759304,36617234,226454067,2323105,9978642,275373048
overview,United Kingdom,K02000001,2021-09-03,82828,1097074,654,12103,1192659,36537749,225725594,2322771,9965653,274551767
overview,United Kingdom,K02000001,2021-09-02,90448,1056770,1240,10421,1158879,36454922,224525916,2322117,9953550,273256505
overview,United Kingdom,K02000001,2021-09-01,103786,915081,859,9808,1029534,36324491,223375485,2320877,9943129,271963982
overview,United Kingdom,K02000001,2021-08-31,99041,812492,610,12802,924945,36220704,222397572,2319360,9933321,270870957
overview,United Kingdom,K02000001,2021-08-30,65443,592565,95,14471,672574,36121663,221533155,2318750,9883518,269857086
overview,United Kingdom,K02000001,2021-08-29,68706,625249,73,13419,707447,36056220,220896335,2318655,9869047,269140257
overview,United Kingdom,K02000001,2021-08-28,60726,649608,172,10008,720514,35987514,220242844,2318582,9855501,268404441
overview,United Kingdom,K02000001,2021-08-27,82218,798268,791,10417,891694,35926789,219559610,2318410,9845493,267650302
overview,United Kingdom,K02000001,2021-08-26,87346,856561,952,5999,950858,35844570,218717506,2317619,9835076,266714771
overview,United Kingdom,K02000001,2021-08-25,100720,811311,1292,13511,926834,35726993,217816698,2316667,9829077,265689435
overview,United Kingdom,K02000001,2021-08-24,109200,628679,947,12920,751746,35626277,216966792,2314751,9815566,264723386
overview,United Kingdom,K02000001,2021-08-23,83361,640846,686,17610,742503,35517080,216298237,2313804,9763752,263892873
overview,United Kingdom,K02000001,2021-08-22,74088,593978,128,11599,679793,35433719,215609602,2313118,9746142,263102581
overview,United Kingdom,K02000001,2021-08-21,72165,570507,367,4362,647401,35359631,214988884,2312990,9734382,262395887
overview,United Kingdom,K02000001,2021-08-20,87112,660845,944,17576,766477,35287466,214404486,2312623,9730020,261734595
overview,United Kingdom,K02000001,2021-08-19,86196,728959,1179,8982,825316,35200354,213708018,2311679,9712444,260932495
overview,United Kingdom,K02000001,2021-08-18,104843,688765,1113,16199,810920,35090682,212937702,2310500,9703462,260042346
overview,United Kingdom,K02000001,2021-08-17,106826,611038,1300,11210,730374,34966087,212214860,2308381,9687263,259176591
overview,United Kingdom,K02000001,2021-08-16,84488,605849,905,9707,700949,34859263,211565621,2307081,9641284,258373249
overview,United Kingdom,K02000001,2021-08-15,69050,592055,30,13374,674509,34774773,210911411,2306176,9631577,257623937
overview,United Kingdom,K02000001,2021-08-14,71158,572123,381,12528,656190,34705725,210319356,2306146,9618067,256949294
overview,United Kingdom,K02000001,2021-08-13,87929,723621,1051,13761,826362,34634566,209747233,2305765,9605539,256293103
overview,United Kingdom,K02000001,2021-08-12,87448,713167,1312,13359,815286,34546638,208975244,2304714,9591778,255418374
overview,United Kingdom,K02000001,2021-08-11,104011,724039,1338,16407,845795,34427628,208220005,2303402,9578419,254529454
overview,United Kingdom,K02000001,2021-08-10,104142,634634,1336,11336,751448,34323617,207461193,2301893,9562012,253648715
overview,United Kingdom,K02000001,2021-08-09,81785,634216,981,11029,728011,34219475,206786589,2300557,9550629,252857250
overview,United Kingdom,K02000001,2021-08-08,70106,606505,63,12763,689437,34137690,206100827,2299576,9507056,252045149
overview,United Kingdom,K02000001,2021-08-07,71815,576734,551,12989,662089,34067585,205465400,2299513,9494270,251326768
overview,United Kingdom,K02000001,2021-08-06,85017,694284,1588,14769,795658,33995770,204859526,2298962,9481281,250635539
overview,United Kingdom,K02000001,2021-08-05,90718,721502,1362,15285,828867,33910755,204121677,2297374,9466512,249796318
overview,United Kingdom,K02000001,2021-08-04,109893,725574,1720,13062,850249,33808698,203354588,2296012,9451114,248910412
overview,United Kingdom,K02000001,2021-08-03,103558,606481,1010,11370,722419,33698805,202592998,2292718,9437796,248022317
overview,United Kingdom,K02000001,2021-08-02,81066,634148,1136,11287,727637,33566933,201942156,2291708,9396135,247196932
overview,United Kingdom,K02000001,2021-08-01,72470,586018,47,12807,671342,33485867,201249922,2290572,9384725,246411086
overview,United Kingdom,K02000001,2021-07-31,76179,587404,175,13613,677371,33413398,200632875,2290525,9371800,245708598
overview,United Kingdom,K02000001,2021-07-30,86452,738873,986,13878,840189,33337219,200013130,2290350,9358187,244998886
overview,United Kingdom,K02000001,2021-07-29,90410,758482,1453,15723,866068,33250767,199230260,2289364,9344309,244114700
overview,United Kingdom,K02000001,2021-07-28,106158,791822,1018,14454,913452,33133245,198420664,2287911,9328586,243170406
overview,United Kingdom,K02000001,2021-07-27,106519,681253,1710,11183,800665,33027090,197587577,2285655,9311163,242211485
overview,United Kingdom,K02000001,2021-07-26,90184,711026,764,10152,812126,32924787,196852622,2283945,9258479,241319833
overview,United Kingdom,K02000001,2021-07-25,68052,710665,53,12327,791097,32830361,196076117,2283181,9248327,240437986
overview,United Kingdom,K02000001,2021-07-24,76535,668412,619,12403,757969,32762309,195328821,2283128,9235841,239610099
overview,United Kingdom,K02000001,2021-07-23,82709,813198,1038,14808,911753,32685774,194621769,2282509,9223438,238813490
overview,United Kingdom,K02000001,2021-07-22,98469,901931,1283,14451,1016134,32603065,193756443,2281471,9173242,237814221
overview,United Kingdom,K02000001,2021-07-21,106055,919001,1334,15995,1042385,32452415,192786351,2280188,9158791,236677745
overview,United Kingdom,K02000001,2021-07-20,102109,774526,1167,10276,888078,32346361,191820988,2278484,9142796,235588629
overview,United Kingdom,K02000001,2021-07-19,82578,984146,1007,9205,1076936,32244252,190986815,2277317,9132520,234640904
overview,United Kingdom,K02000001,2021-07-18,66507,962205,85,12387,1041184,32133460,189865185,2276310,9123315,233398270
overview,United Kingdom,K02000001,2021-07-17,64599,706493,401,13130,784623,32066953,188856442,2276225,9110838,232310458
overview,United Kingdom,K02000001,2021-07-16,78801,882685,1746,15814,979046,32002354,188112545,2275824,9097708,231488431
overview,United Kingdom,K02000001,2021-07-15,85855,1077296,1409,16512,1181072,31923553,187167136,2274078,9081894,230446661
overview,United Kingdom,K02000001,2021-07-14,108556,1082320,1338,20966,1213180,31802677,185989933,2272669,9065382,229130661
overview,United Kingdom,K02000001,2021-07-13,106837,813801,1593,13191,935422,31694121,184850193,2270916,9044416,227859646
overview,United Kingdom,K02000001,2021-07-12,83597,972603,734,20324,1077258,31587284,183960384,2269323,8995994,226812985
overview,United Kingdom,K02000001,2021-07-11,64844,1035257,162,24682,1124945,31503687,182875208,2268589,8902413,225549897
overview,United Kingdom,K02000001,2021-07-10,69826,653961,651,19123,743561,31438846,181799114,2268427,8877626,224384013
overview,United Kingdom,K02000001,2021-07-09,87223,806972,1699,9100,904994,31369020,181107022,2267776,8858503,223602321
overview,United Kingdom,K02000001,2021-07-08,96144,992374,1796,27614,1117928,31281798,180235428,2266077,8849403,222632706
overview,United Kingdom,K02000001,2021-07-07,110459,1104936,1697,23430,1240522,31163742,179138800,2264281,8821789,221388612
overview,United Kingdom,K02000001,2021-07-06,105380,848136,1296,16464,971276,31053284,177980256,2262206,8798359,220094105
overview,United Kingdom,K02000001,2021-07-05,90719,1053902,886,17085,1162592,30947905,177058482,2260910,8748500,219015797
overview,United Kingdom,K02000001,2021-07-04,74756,1181397,23,20440,1276616,30857188,175902946,2260024,8731415,217751573
overview,United Kingdom,K02000001,2021-07-03,73619,565716,231,20003,659569,30782432,174680777,2260001,8710794,216434004
overview,United Kingdom,K02000001,2021-07-02,89827,766560,1472,21128,878987,30708813,174075604,2259770,8690791,215734978
overview,United Kingdom,K02000001,2021-07-01,95618,1006329,864,20329,1123140,30618986,173239898,2258298,8669663,214786845
overview,United Kingdom,K02000001,2021-06-30,100763,1130138,1238,22438,1254577,30501519,172122186,2257434,8649334,213530473
overview,United Kingdom,K02000001,2021-06-29,107736,761196,1383,13691,884006,30400756,170937840,2255797,8626896,212221289
overview,United Kingdom,K02000001,2021-06-28,86690,992563,889,17179,1097321,30293020,170102615,2254414,8577886,211227935
overview,United Kingdom,K02000001,2021-06-27,70862,1130921,40,14899,1216722,30206330,168974358,2253525,8560707,209994920
overview,United Kingdom,K02000001,2021-06-26,71279,534253,322,16714,622568,30135468,167804441,2253485,8545458,208738852
overview,United Kingdom,K02000001,2021-06-25,87596,749080,1359,15617,853652,30064189,167234292,2253163,8528744,208080388
overview,United Kingdom,K02000001,2021-06-24,91495,961330,1429,15500,1069754,29976593,166422640,2251804,8513127,207164164
overview,United Kingdom,K02000001,2021-06-23,103892,1042262,1234,6423,1153811,29868152,165347512,2250375,8497627,205963666
overview,United Kingdom,K02000001,2021-06-22,112019,700176,1426,10093,823714,29764260,164255143,2247850,8491204,204758457
overview,United Kingdom,K02000001,2021-06-21,88888,922925,1125,8117,1021055,29652242,163486908,2246424,8460442,203846016
overview,United Kingdom,K02000001,2021-06-20,70139,1063265,88,15878,1149370,29563354,162428138,2245299,8452325,202689116
overview,United Kingdom,K02000001,2021-06-19,72135,500554,277,19182,592148,29493215,161330059,2245211,8436153,201504638
overview,United Kingdom,K02000001,2021-06-18,87485,685969,1815,19332,794601,29421080,160799730,2244934,8416971,200882715
overview,United Kingdom,K02000001,2021-06-17,95030,928122,1812,13197,1038161,29333596,160050490,2243119,8397639,200024844
overview,United Kingdom,K02000001,2021-06-16,105760,982750,1660,15566,1105736,29209253,159009075,2241307,8384442,198844077
overview,United Kingdom,K02000001,2021-06-15,112942,654065,1707,10977,779691,29103493,157975270,2238236,8368876,197685875
overview,United Kingdom,K02000001,2021-06-14,79687,842792,792,8141,931412,28990551,157251682,2236529,8320818,196799580
overview,United Kingdom,K02000001,2021-06-13,68211,971037,435,12974,1052657,28910864,156275376,2235737,8312677,195734654
overview,United Kingdom,K02000001,2021-06-12,70252,446362,273,17195,534082,28842653,155272155,2235302,8299158,194649268
overview,United Kingdom,K02000001,2021-06-11,85249,641575,1562,10956,739342,28772401,154791014,2235029,8281963,194080407
overview,United Kingdom,K02000001,2021-06-10,87616,841323,1725,17852,948516,28687153,154072394,2233467,8271007,193264021
overview,United Kingdom,K02000001,2021-06-09,102760,961619,1785,22551,1088715,28564625,153127621,2231742,8253155,192177143
overview,United Kingdom,K02000001,2021-06-08,107575,608077,1729,13852,731233,28461865,152122594,2229546,8230604,191044609
overview,United Kingdom,K02000001,2021-06-07,80408,834996,1706,13655,930765,28354291,151448795,2227817,8198022,190228925
overview,United Kingdom,K02000001,2021-06-06,72075,1153179,357,16814,1242425,28273883,150486797,2226111,8184367,189171158
overview,United Kingdom,K02000001,2021-06-05,71820,396844,595,20178,489437,28201808,149298005,2225754,8167086,187892653
overview,United Kingdom,K02000001,2021-06-04,80109,570381,2386,21221,674097,28129988,148868636,2225159,8146904,187370687
overview,United Kingdom,K02000001,2021-06-03,82389,702458,2201,23430,810478,28049880,148244881,2222773,8125683,186643217
overview,United Kingdom,K02000001,2021-06-02,98077,738820,1856,19657,858410,27947193,147465062,2220572,8102253,185735080
overview,United Kingdom,K02000001,2021-06-01,94458,559030,1402,12555,667445,27849117,146677514,2217987,8082596,184827214
overview,United Kingdom,K02000001,2021-05-31,63547,521852,217,16620,602236,27754659,146049107,2216585,8033656,184054007
overview,United Kingdom,K02000001,2021-05-30,65988,538188,260,21710,626146,27691112,145446766,2216368,8017036,183371282
overview,United Kingdom,K02000001,2021-05-29,61074,404058,524,23142,488798,27625124,144882687,2216108,7995231,182719150
overview,United Kingdom,K02000001,2021-05-28,79188,574749,2105,26596,682638,27564050,144447693,2215584,7972089,182199416
overview,United Kingdom,K02000001,2021-05-27,84897,850456,1989,25974,963316,27484862,143809385,2213479,7945493,181453219
overview,United Kingdom,K02000001,2021-05-26,104066,1003755,1862,28724,1138407,27378380,142847084,2211490,7921534,180358488
overview,United Kingdom,K02000001,2021-05-25,107642,619847,1856,18593,747938,27274315,141789562,2208509,7892810,179165196
overview,United Kingdom,K02000001,2021-05-24,89434,843406,1756,23862,958458,27166674,141097747,2206653,7835984,178307058
overview,United Kingdom,K02000001,2021-05-23,68889,1083944,209,17803,1170845,27077240,140104146,2204897,7812122,177198405
overview,United Kingdom,K02000001,2021-05-22,77062,407315,417,18875,503669,27008352,138983268,2204688,7794045,175990353
overview,United Kingdom,K02000001,2021-05-21,82626,616580,2380,22871,724457,26931290,138542021,2204271,7775170,175452752
overview,United Kingdom,K02000001,2021-05-20,85774,883134,2089,25531,996528,26848665,137853007,2201891,7752299,174655862
overview,United Kingdom,K02000001,2021-05-19,106365,1057313,1991,28573,1194242,26737134,136838828,2199802,7726768,173502532
overview,United Kingdom,K02000001,2021-05-18,105360,615392,1701,29222,751675,26630780,135731471,2196419,7698195,172256865
overview,United Kingdom,K02000001,2021-05-17,81894,877052,1391,33489,993826,26525421,135043353,2194718,7634941,171398433
overview,United Kingdom,K02000001,2021-05-16,69144,1004450,90,37304,1110988,26417557,133943835,2193327,7601452,170156171
overview,United Kingdom,K02000001,2021-05-15,74921,372413,503,39737,487574,26348413,132901405,2193237,7564093,169007148
overview,United Kingdom,K02000001,2021-05-14,84354,576478,2233,45755,708820,26273492,132498576,2192734,7524356,168489158
overview,United Kingdom,K02000001,2021-05-13,87577,880112,1971,53869,1023529,26189138,131840525,2190501,7478601,167698765
overview,United Kingdom,K02000001,2021-05-12,101533,1065631,2735,39570,1209469,26085072,133308861,2188530,7424732,169007195
overview,United Kingdom,K02000001,2021-05-11,106103,592503,1539,13773,713918,25983539,132195808,2184561,7385162,167749070
overview,United Kingdom,K02000001,2021-05-10,84504,862080,1788,8895,957267,25877436,131529945,2183022,7351811,166942214
overview,United Kingdom,K02000001,2021-05-09,73216,1233565,358,15557,1322696,25792932,130504693,2181234,7342824,165821683
overview,United Kingdom,K02000001,2021-05-08,74415,401507,1159,14624,491705,25719716,129236056,2180876,7327267,164463915
overview,United Kingdom,K02000001,2021-05-07,89166,605562,2114,14779,711621,25645301,128798304,2179717,7312643,163935965
overview,United Kingdom,K02000001,2021-05-06,88162,963396,1675,18026,1071259,25556135,128141913,2177603,7296126,163171777
overview,United Kingdom,K02000001,2021-05-05,110765,1087576,2202,17948,1218491,25451310,127045210,2175928,7261225,161933673
overview,United Kingdom,K02000001,2021-05-04,94868,751134,1494,14366,861862,25340545,125897732,2172122,7243277,160653676
overview,United Kingdom,K02000001,2021-05-03,69602,986171,296,13951,1070020,25245677,125012016,2170628,7228911,159657232
overview,United Kingdom,K02000001,2021-05-02,66941,748059,545,17918,833463,25176075,123881903,2170332,7214960,158443270
overview,United Kingdom,K02000001,2021-05-01,62887,405678,590,17075,486230,25109135,123098616,2169787,7196839,157574377
overview,United Kingdom,K02000001,2021-04-30,83804,564272,2082,19710,669868,25046248,122658519,2169197,7179764,157053728
overview,United Kingdom,K02000001,2021-04-29,89231,959796,1970,25122,1076119,24962445,122013210,2167115,7160054,156302824
overview,United Kingdom,K02000001,2021-04-28,108932,1226188,1738,27264,1364122,24863322,120907889,2165145,7136350,155072706
overview,United Kingdom,K02000001,2021-04-27,103409,607528,1659,20487,733083,24754391,119627154,2161901,7109086,153652532
overview,United Kingdom,K02000001,2021-04-26,82194,928974,1557,24505,1037230,24650984,118940384,2160242,7072020,152823630
overview,United Kingdom,K02000001,2021-04-25,73089,1380290,499,24330,1478208,24568814,117830637,2158685,7047515,151605651
overview,United Kingdom,K02000001,2021-04-24,78221,399096,984,25346,503647,24495725,116411494,2158186,7022945,150088350
overview,United Kingdom,K02000001,2021-04-23,85981,611728,3047,25387,726143,24417504,115976898,2157202,6997599,149549203
overview,United Kingdom,K02000001,2021-04-22,85975,993857,2322,33946,1116100,24331523,115279971,2154155,6972105,148737754
overview,United Kingdom,K02000001,2021-04-21,101351,1254128,2640,17290,1375409,24245548,114133243,2151833,6938159,147468783
overview,United Kingdom,K02000001,2021-04-20,109180,604049,1821,18629,733679,24144197,112829138,2149193,6920869,146043397
overview,United Kingdom,K02000001,2021-04-19,85837,941757,1440,15788,1044822,24018947,112148162,2146290,6884009,145197408
overview,United Kingdom,K02000001,2021-04-18,67242,1604231,227,5385,1677085,23933110,111030127,2144850,6850532,143958619
overview,United Kingdom,K02000001,2021-04-17,67847,411797,927,13182,493753,23865868,109384727,2144623,6845147,142240365
overview,United Kingdom,K02000001,2021-04-16,81745,588138,2116,12190,684189,23798021,108935391,2143696,6831965,141709073
overview,United Kingdom,K02000001,2021-04-15,80590,895315,2301,14601,992807,23716276,108266397,2141580,6819775,140944028
overview,United Kingdom,K02000001,2021-04-14,96369,1049408,2280,20135,1168192,23635686,107244222,2139279,6805174,139824361
overview,United Kingdom,K02000001,2021-04-13,107833,560740,2010,12279,682862,23539317,106146046,2136229,6785039,138606631
overview,United Kingdom,K02000001,2021-04-12,78050,785255,1874,12612,877791,23431485,105510067,2134219,6772671,137848442
overview,United Kingdom,K02000001,2021-04-11,63116,1143447,515,11474,1218552,23343831,104587086,2130885,6760059,136821861
overview,United Kingdom,K02000001,2021-04-10,76902,392004,915,13247,483068,23279861,103407861,2130370,6748585,135566677
overview,United Kingdom,K02000001,2021-04-09,86601,575712,2805,16179,681297,23202959,102978254,2129455,6735072,135045740
overview,United Kingdom,K02000001,2021-04-08,89955,824848,2498,19511,936812,23116358,102327226,2126650,6718893,134289127
overview,United Kingdom,K02000001,2021-04-07,94267,921483,2354,21088,1039192,23018229,101391299,2124152,6699382,133233062
overview,United Kingdom,K02000001,2021-04-06,91304,529472,2215,11162,634153,22923962,100417526,2121798,6678294,132141580
overview,United Kingdom,K02000001,2021-04-05,73114,667650,440,559,741763,22832658,99807877,2119583,6647627,131407745
overview,United Kingdom,K02000001,2021-04-04,63581,739343,378,10769,814071,22759544,99009318,2119143,6647068,130535073
overview,United Kingdom,K02000001,2021-04-03,58798,333933,535,12903,406169,22695963,98240434,2118765,6636021,129691183
overview,United Kingdom,K02000001,2021-04-02,61714,481181,1215,12718,556828,22637166,97871753,2118230,6623118,129250267
overview,United Kingdom,K02000001,2021-04-01,87942,851448,2520,16227,958137,22575452,97327216,2117015,6610400,128630083
overview,United Kingdom,K02000001,2021-03-31,89400,1155454,2044,23462,1270360,22487510,96350691,2114495,6594173,127546869
overview,United Kingdom,K02000001,2021-03-30,99618,580385,2348,17368,699719,22389859,95147183,2113057,6570711,126220810
overview,United Kingdom,K02000001,2021-03-29,81847,875539,1329,15021,973736,22290241,94530449,2110709,6542860,125474259
overview,United Kingdom,K02000001,2021-03-28,63107,1559664,2082,19295,1644148,22208394,93606708,2109380,6527839,124452321
overview,United Kingdom,K02000001,2021-03-27,70434,380684,950,21092,473160,22145287,92021308,2107298,6508244,122782137
overview,United Kingdom,K02000001,2021-03-26,81709,616377,1939,25554,725579,22074853,91611004,2106348,6487152,122279357
overview,United Kingdom,K02000001,2021-03-25,88733,1163972,2379,24090,1279174,21993145,90958247,2104409,6461598,121517399
overview,United Kingdom,K02000001,2021-03-24,99648,1685906,2112,30571,1818237,21890901,89643982,2102030,6437508,120074421
overview,United Kingdom,K02000001,2021-03-23,98886,721036,2272,22844,845038,21791253,87908288,2098417,6406937,118204895
overview,United Kingdom,K02000001,2021-03-22,78604,1090436,2602,25275,1196917,21692367,87116538,2096145,6374527,117279577
overview,United Kingdom,K02000001,2021-03-21,66520,1802315,1112,25407,1895354,21613763,85889134,2093543,6349252,115945692
overview,United Kingdom,K02000001,2021-03-20,69424,377256,1194,27218,475092,21547243,84062849,2092431,6323450,114025973
overview,United Kingdom,K02000001,2021-03-19,79117,828414,2694,28959,939184,21477820,83653929,2091237,6296232,113519218
overview,United Kingdom,K02000001,2021-03-18,88341,1321954,2566,28478,1441339,21398706,82738625,2088543,6267273,112493147
overview,United Kingdom,K02000001,2021-03-17,96221,1510077,2757,31039,1640094,21295649,81293584,2085977,6238795,110914005
overview,United Kingdom,K02000001,2021-03-16,98430,1203115,1987,19470,1323002,21189731,79693153,2082280,6207756,109172920
overview,United Kingdom,K02000001,2021-03-15,72576,1483711,1545,18331,1576163,21091301,78382952,2080293,6177419,107731965
overview,United Kingdom,K02000001,2021-03-14,65347,885406,265,14374,965392,21018726,76789661,2078748,6159088,106046223
overview,United Kingdom,K02000001,2021-03-13,69053,354454,711,14451,438669,20953379,75877567,2078483,6144214,105053643
overview,United Kingdom,K02000001,2021-03-12,79916,1308282,2788,16419,1407405,20884326,75488928,2077772,6129763,104580789
overview,United Kingdom,K02000001,2021-03-11,85550,1511972,2490,18347,1618359,20804410,74061200,2074984,6113344,103053938
overview,United Kingdom,K02000001,2021-03-10,98702,1436785,3079,20961,1559527,20718860,72427872,2072494,6094997,101314223
overview,United Kingdom,K02000001,2021-03-09,89309,1272551,2542,12722,1377124,20609572,70889450,2067702,6074036,99640760
overview,United Kingdom,K02000001,2021-03-08,77360,1440664,2052,11565,1531641,20520263,69502488,2065160,6045655,98133566
overview,United Kingdom,K02000001,2021-03-07,60812,732240,646,12692,806390,20442903,67980416,2063108,6034090,96520517
overview,United Kingdom,K02000001,2021-03-06,71310,367847,665,13593,453415,20382092,67229367,2062462,6021159,95695080
overview,United Kingdom,K02000001,2021-03-05,84098,854220,2757,15402,956477,20310782,66831085,2061797,6007566,95211230
overview,United Kingdom,K02000001,2021-03-04,82292,892222,2635,18337,995486,20226684,65919141,2059040,5992164,94197029
overview,United Kingdom,K02000001,2021-03-03,99065,745096,2394,19497,866052,20144393,64973689,2056405,5973827,93148314
overview,United Kingdom,K02000001,2021-03-02,95607,566928,2200,13101,677836,20045332,64199706,2054011,5954330,92253379
overview,United Kingdom,K02000001,2021-03-01,72446,643332,1488,12372,729638,19932778,63595387,2051297,5941229,91520691
overview,United Kingdom,K02000001,2021-02-28,57753,453191,469,15751,527164,19860333,62912317,2049809,5916737,90739196
overview,United Kingdom,K02000001,2021-02-27,72841,294875,1025,16248,384989,19792768,62449256,2049340,5900705,90192069
overview,United Kingdom,K02000001,2021-02-26,80864,508327,2112,16437,607740,19719927,62142504,2048315,5884457,89795203
overview,United Kingdom,K02000001,2021-02-25,83691,632521,3678,15516,735406,19639063,61609259,2046203,5868020,89162545
overview,United Kingdom,K02000001,2021-02-24,96556,621507,2236,22958,743257,19551100,60940920,2042525,5852504,88387049
overview,United Kingdom,K02000001,2021-02-23,94988,484459,2270,15528,597245,19454544,60298933,2038565,5829546,87621588
overview,United Kingdom,K02000001,2021-02-22,75839,577597,2114,17273,672823,19359558,59786649,2036295,5798040,86980542
overview,United Kingdom,K02000001,2021-02-21,60522,507019,454,23133,591128,19283719,59173500,2034181,5780767,86272167
overview,United Kingdom,K02000001,2021-02-20,75205,309069,846,23954,409074,19223197,58657271,2033727,5757230,85671425
overview,United Kingdom,K02000001,2021-02-19,79716,416580,2100,26091,524487,19147992,58338570,2032881,5733276,85252719
overview,United Kingdom,K02000001,2021-02-18,81500,449301,3019,31304,565124,19068278,57904143,2030781,5707185,84710387
overview,United Kingdom,K02000001,2021-02-17,95596,450756,2490,33368,582210,18986779,57434678,2027762,5675881,84125100
overview,United Kingdom,K02000001,2021-02-16,97222,369040,2683,23179,492124,18891184,56968093,2026028,5642513,83527818
overview,United Kingdom,K02000001,2021-02-15,79119,352082,1859,26584,459644,18788844,56579585,2023345,5619334,83011108
overview,United Kingdom,K02000001,2021-02-14,53954,319530,439,28302,402225,18712237,56201457,2021486,5592750,82527930
overview,United Kingdom,K02000001,2021-02-13,60154,308093,2614,35754,406615,18658283,55873889,2021047,5564209,82117428
overview,United Kingdom,K02000001,2021-02-12,82616,510719,3637,34033,631005,18598129,55552641,2018433,5528455,81697658
overview,United Kingdom,K02000001,2021-02-11,82093,617341,2432,31218,733084,18515513,55019276,2014796,5494422,81044007
overview,United Kingdom,K02000001,2021-02-10,98895,632701,2776,32288,766660,18433422,54359812,2011014,5463204,80267452
overview,United Kingdom,K02000001,2021-02-09,99334,448603,2545,31329,581811,18331651,53700899,2008238,5430916,79471704
overview,United Kingdom,K02000001,2021-02-08,70702,534364,2202,13866,621134,18232317,53227211,2005693,5395430,78860651
overview,United Kingdom,K02000001,2021-02-07,62780,506896,537,17060,587273,18161615,52659616,2003491,5381564,78206286
overview,United Kingdom,K02000001,2021-02-06,69411,367292,904,18838,456445,18086820,52143381,2004482,5364173,77598856
overview,United Kingdom,K02000001,2021-02-05,83450,570016,2803,20164,676433,18017409,51764037,2003578,5345335,77130359
overview,United Kingdom,K02000001,2021-02-04,93084,672639,3004,23110,791837,17933962,51172258,2000775,5325171,76432166
overview,United Kingdom,K02000001,2021-02-03,100517,678381,2996,26941,808835,17840879,50469741,1997771,5302061,75610452
overview,United Kingdom,K02000001,2021-02-02,90618,501704,2579,20419,615320,17740363,49771696,1994775,5275120,74781954
overview,United Kingdom,K02000001,2021-02-01,73060,557384,1931,23278,655653,17649745,49245773,1992196,5245177,74132891
overview,United Kingdom,K02000001,2021-01-31,60479,496085,672,25057,582293,17576685,48659972,1990265,5221899,73448821
overview,United Kingdom,K02000001,2021-01-30,73203,347004,1880,28521,450608,17494415,48155658,1988239,5196440,72834752
overview,United Kingdom,K02000001,2021-01-29,91587,553496,3887,30137,679107,17421216,47799885,1986359,5167919,72375379
overview,United Kingdom,K02000001,2021-01-28,92130,642969,2974,41386,779459,17329645,47227463,1982472,5137782,71677362
overview,United Kingdom,K02000001,2021-01-27,103461,646588,2896,65511,818456,17237516,46559536,1979498,5095852,70872402
overview,United Kingdom,K02000001,2021-01-26,101514,482611,2445,59575,646145,17134057,45896093,1976602,5030341,70037093
overview,United Kingdom,K02000001,2021-01-25,73497,457607,2330,13300,546734,17032544,45392920,1974157,4960201,69359822
overview,United Kingdom,K02000001,2021-01-24,60360,334119,571,17725,412775,16959047,44916544,1971827,4946901,68794319
overview,United Kingdom,K02000001,2021-01-23,83930,381301,745,20449,486425,16898687,44575925,1971256,4929176,68375044
overview,United Kingdom,K02000001,2021-01-22,79827,529002,2485,20587,631901,16814758,44187656,1970511,4908727,67881652
overview,United Kingdom,K02000001,2021-01-21,96800,547737,2803,21649,668989,16734931,43639959,1968026,4888150,67231066
overview,United Kingdom,K02000001,2021-01-20,104582,512639,2842,24987,645050,16638132,43077722,1963692,4866501,66546047
overview,United Kingdom,K02000001,2021-01-19,97952,461109,2506,21371,582938,16523147,42550035,1960850,4841514,65875546
overview,United Kingdom,K02000001,2021-01-18,69517,467511,2993,19918,559939,16425195,42069013,1958344,4811185,65263737
overview,United Kingdom,K02000001,2021-01-17,63053,332684,636,21592,417965,16355678,41574690,1955351,4791267,64676986
overview,United Kingdom,K02000001,2021-01-16,79605,389799,640,22530,492574,16292628,41234634,1954715,4769675,64251652
overview,United Kingdom,K02000001,2021-01-15,85313,490024,2831,22685,600853,16213023,40834871,1954075,4747145,63749114
overview,United Kingdom,K02000001,2021-01-14,84870,576959,3009,34541,699379,16127711,40335754,1951244,4724460,63139169
overview,United Kingdom,K02000001,2021-01-13,94843,500327,2781,34516,632467,16042841,39749577,1948235,4689919,62430572
overview,United Kingdom,K02000001,2021-01-12,99235,447659,2763,38487,588144,15940850,39237923,1945454,4655403,61779630
overview,United Kingdom,K02000001,2021-01-11,73163,444386,1922,19398,538869,15841617,38781269,1942691,4595158,61160735
overview,United Kingdom,K02000001,2021-01-10,70373,371809,575,43692,486449,15768454,38323478,1940201,4575760,60607893
overview,United Kingdom,K02000001,2021-01-09,80508,447503,946,39291,568248,15698081,37949285,1939626,4532068,60119060
overview,United Kingdom,K02000001,2021-01-08,89752,557473,2570,32998,682793,15617577,37499573,1938920,4492777,59548847
overview,United Kingdom,K02000001,2021-01-07,97158,502113,3490,21026,623787,15527825,36936747,1936355,4459779,58860706
overview,United Kingdom,K02000001,2021-01-06,94932,445142,3206,17937,561217,15430667,36429445,1932865,4438753,58231730
overview,United Kingdom,K02000001,2021-01-05,100110,383697,2522,14995,501324,15335735,35971102,1929659,4415937,57652433
overview,United Kingdom,K02000001,2021-01-04,72190,378918,1989,13503,466600,15232991,35583403,1927137,4400824,57144355
overview,United Kingdom,K02000001,2021-01-03,62391,354571,718,11808,429488,15150009,35203050,1925148,4387304,56665511
overview,United Kingdom,K02000001,2021-01-02,64718,345633,550,1172,412073,15087618,34847580,1924430,4375496,56235124
overview,United Kingdom,K02000001,2021-01-01,59346,344619,596,18839,423400,15022990,34501048,1923880,4374324,55822242
overview,United Kingdom,K02000001,2020-12-31,79254,403219,2974,90,485537,14963644,34155477,1923284,4355485,55397890
overview,United Kingdom,K02000001,2020-12-30,83792,317551,2448,19791,423582,14884302,33732977,1920310,4355395,54892984
overview,United Kingdom,K02000001,2020-12-29,65937,257586,1959,21963,347445,14800425,33413136,1917862,4335604,54467027
overview,United Kingdom,K02000001,2020-12-28,57893,293247,642,6098,357880,14734579,33154011,1915903,4313641,54118134
overview,United Kingdom,K02000001,2020-12-27,53061,299641,588,0,353290,14676686,32859968,1915261,4307543,53759458
overview,United Kingdom,K02000001,2020-12-26,45832,224044,735,0,270611,14623625,32491556,1914673,4307543,53337397
overview,United Kingdom,K02000001,2020-12-25,44400,294624,588,0,339612,14577793,32266966,1913938,4307543,53066240
overview,United Kingdom,K02000001,2020-12-24,79218,383905,3078,72,466273,14533393,31972127,1913350,4307543,52726413
overview,United Kingdom,K02000001,2020-12-23,87735,403973,3105,18045,512858,14454175,31587793,1910272,4307471,52259711
overview,United Kingdom,K02000001,2020-12-22,91358,347583,2349,14962,456252,14366420,31183458,1907699,4289426,51747003
overview,United Kingdom,K02000001,2020-12-21,68678,335252,2457,19745,426132,14272637,30835586,1904556,4274464,51287243
overview,United Kingdom,K02000001,2020-12-20,68750,337258,480,27462,433950,14195457,30499388,1901588,4254718,50851151
overview,United Kingdom,K02000001,2020-12-19,85095,344498,1662,10991,442246,14126707,30162031,1901108,4227256,50417102
overview,United Kingdom,K02000001,2020-12-18,86552,286039,2718,18843,394152,14041612,29817391,1899446,4216265,49974714
overview,United Kingdom,K02000001,2020-12-17,91519,272784,2651,11325,378279,13955023,29530375,1896728,4197422,49579548
overview,United Kingdom,K02000001,2020-12-16,93680,255332,3549,15981,368542,13863505,29235184,1894077,4186097,49178863
overview,United Kingdom,K02000001,2020-12-15,96381,194396,2679,13583,307039,13769912,28979694,1890528,4170116,48810250
overview,United Kingdom,K02000001,2020-12-14,74189,191349,2172,10234,277944,13664776,28785232,1887707,4150453,48488168
overview,United Kingdom,K02000001,2020-12-13,67277,230518,365,14478,312638,13590587,28593857,1885535,4139108,48209087
overview,United Kingdom,K02000001,2020-12-12,74650,264712,966,19129,359457,13523311,28363320,1885170,4124630,47896431
overview,United Kingdom,K02000001,2020-12-11,86426,285377,2896,20811,395510,13448661,28098589,1884204,4105501,47536955
overview,United Kingdom,K02000001,2020-12-10,89800,288925,2611,22900,404236,13362235,27813111,1881308,4084690,47141344
overview,United Kingdom,K02000001,2020-12-09,94192,259307,2401,16546,372446,13272436,27524151,1878697,4055715,46730999
overview,United Kingdom,K02000001,2020-12-08,88307,193825,1990,13098,297220,13165306,27264784,1875444,4039169,46344703
overview,United Kingdom,K02000001,2020-12-07,69258,136057,2074,10666,218055,13077001,27070864,1873301,4026071,46047237
overview,United Kingdom,K02000001,2020-12-06,62236,194677,335,15874,273122,13005379,26934742,1871227,4015405,45826753
overview,United Kingdom,K02000001,2020-12-05,77373,257878,1417,19548,356216,12943144,26740020,1870892,3999531,45553587
overview,United Kingdom,K02000001,2020-12-04,84819,274488,3393,22414,385114,12865771,26482099,1869475,3979983,45197328
overview,United Kingdom,K02000001,2020-12-03,87529,277949,2916,24822,393216,12780952,26207536,1866082,3957569,44812139
overview,United Kingdom,K02000001,2020-12-02,92946,236521,2932,24119,356518,12691950,25928892,1862831,3932747,44416420
overview,United Kingdom,K02000001,2020-12-01,88113,204744,2563,19501,314921,12599004,25692320,1859899,3908628,44059851
overview,United Kingdom,K02000001,2020-11-30,66275,130663,1674,17897,216509,12508475,25483842,1856762,3880502,43729581
overview,United Kingdom,K02000001,2020-11-29,60243,133585,478,26071,220377,12442200,25334757,1855054,3847012,43479023
overview,United Kingdom,K02000001,2020-11-28,73096,210867,729,27163,311855,12379830,25201157,1853770,3820941,43255698
overview,United Kingdom,K02000001,2020-11-27,83971,221367,2757,29386,337481,12306748,24990087,1853041,3793778,42943654
overview,United Kingdom,K02000001,2020-11-26,86178,266666,3521,31580,387945,12222777,24768450,1850284,3764392,42605903
overview,United Kingdom,K02000001,2020-11-25,90440,235738,2955,30464,359597,12136016,24501669,1846709,3732812,42217206
overview,United Kingdom,K02000001,2020-11-24,94663,193647,2862,23628,314800,12047544,24265137,1843754,3702348,41858783
overview,United Kingdom,K02000001,2020-11-23,68486,116831,2387,27216,214920,11950359,24070442,1840762,3672080,41533643
overview,United Kingdom,K02000001,2020-11-22,60607,171975,417,46459,279458,11880462,23953113,1838375,3644864,41316814
overview,United Kingdom,K02000001,2020-11-21,79718,250462,903,38860,369943,11815788,23780874,1837835,3598405,41032902
overview,United Kingdom,K02000001,2020-11-20,79868,274623,2952,38438,395881,11736070,23530373,1836157,3559545,40662145
overview,United Kingdom,K02000001,2020-11-19,89859,268024,2912,39134,399929,11656202,23255669,1833205,3521107,40266183
overview,United Kingdom,K02000001,2020-11-18,92530,244412,3072,27612,367626,11564754,22981446,1829873,3481973,39858046
overview,United Kingdom,K02000001,2020-11-17,87362,184211,2832,12141,286546,11470365,22728537,1826789,3454361,39480052
overview,United Kingdom,K02000001,2020-11-16,68340,148910,2440,16939,236629,11382248,22544155,1823853,3438070,39188326
overview,United Kingdom,K02000001,2020-11-15,62837,201208,796,19821,284662,11313396,22377164,1821024,3421131,38932715
overview,United Kingdom,K02000001,2020-11-14,76044,254629,895,13111,344679,11252054,22175887,1820091,3401310,38649342
overview,United Kingdom,K02000001,2020-11-13,85762,278448,2802,18904,385916,11176010,21921151,1819196,3388199,38304556
overview,United Kingdom,K02000001,2020-11-12,88945,273346,3694,18014,383999,11090248,21642589,1816394,3369295,37918526
overview,United Kingdom,K02000001,2020-11-11,89693,263690,3498,24762,381643,11000634,21369089,1812655,3351281,37533659
overview,United Kingdom,K02000001,2020-11-10,88116,197430,3590,21005,310141,10909496,21103371,1809897,3324347,37147111
overview,United Kingdom,K02000001,2020-11-09,68317,160066,2787,19121,250291,10821827,20905846,1806232,3303342,36837247
overview,United Kingdom,K02000001,2020-11-08,63578,199582,629,22575,286364,10752723,20745721,1803443,3284221,36586108
overview,United Kingdom,K02000001,2020-11-07,71369,237923,866,22371,332529,10686113,20546139,1802790,3261646,36296688
overview,United Kingdom,K02000001,2020-11-06,82883,258509,3490,17767,362649,10614744,20308216,1801645,3239275,35963880
overview,United Kingdom,K02000001,2020-11-05,80051,244080,3603,27817,355551,10531861,20049707,1798155,3221416,35601139
overview,United Kingdom,K02000001,2020-11-04,89630,195950,3120,19972,308672,10450905,19802946,1794522,3193599,35241972
overview,United Kingdom,K02000001,2020-11-03,75197,177027,3612,19650,275486,10353713,19602448,1791402,3173627,34921190
overview,United Kingdom,K02000001,2020-11-02,66290,121737,2289,29005,219321,10276026,19422209,1787750,3148578,34634563
overview,United Kingdom,K02000001,2020-11-01,57972,185050,647,39340,283009,10208773,19287665,1784221,3119573,34400232
overview,United Kingdom,K02000001,2020-10-31,73983,202171,1011,31067,308232,10148888,19102615,1783572,3080233,34115308
overview,United Kingdom,K02000001,2020-10-30,76479,200623,2905,50230,330237,10072464,18900444,1782112,3049166,33804186
overview,United Kingdom,K02000001,2020-10-29,74031,243222,3266,57566,378085,9995421,18696990,1778958,2998936,33470305
overview,United Kingdom,K02000001,2020-10-28,81764,203880,3338,54840,343822,9919094,18453768,1775688,2941370,33089920
overview,United Kingdom,K02000001,2020-10-27,80017,176922,3214,50982,311135,9837190,18249888,1772350,2886530,32745958
overview,United Kingdom,K02000001,2020-10-26,63458,158147,2489,40256,264350,9754345,18068846,1769123,2825802,32418116
overview,United Kingdom,K02000001,2020-10-25,60363,230863,622,29888,321736,9688390,17910699,1766634,2785546,32151269
overview,United Kingdom,K02000001,2020-10-24,71743,210368,1463,35785,319359,9628027,17679836,1766012,2755658,31829533
overview,United Kingdom,K02000001,2020-10-23,82458,229950,3618,35710,351736,9556284,17469468,1764549,2719873,31510174
overview,United Kingdom,K02000001,2020-10-22,81879,231440,3419,27174,343912,9473664,17239518,1760657,2684163,31158002
overview,United Kingdom,K02000001,2020-10-21,84279,198286,3511,28785,314861,9388370,17006668,1757150,2656989,30809177
overview,United Kingdom,K02000001,2020-10-20,77740,180880,3886,21376,283882,9298879,16802826,1753268,2628204,30483177
overview,United Kingdom,K02000001,2020-10-19,64568,169118,3192,26652,263530,9218826,16621946,1749346,2597797,30187915
overview,United Kingdom,K02000001,2020-10-18,57355,223529,495,26009,307388,9152008,16452828,1746154,2571145,29922135
overview,United Kingdom,K02000001,2020-10-17,69597,207980,1226,30839,309642,9094653,16229299,1745659,2545136,29614747
overview,United Kingdom,K02000001,2020-10-16,75060,214369,4419,24408,318256,9025056,16021319,1744433,2514297,29305105
overview,United Kingdom,K02000001,2020-10-15,79441,199272,3742,26401,308856,8950022,15806950,1739991,2489889,28986852
overview,United Kingdom,K02000001,2020-10-14,80081,193713,3891,22838,300523,8870205,15607678,1736207,2463488,28677578
overview,United Kingdom,K02000001,2020-10-13,70587,179296,3163,15096,268142,8784309,15413965,1732156,2440650,28371080
overview,United Kingdom,K02000001,2020-10-12,57007,142204,2698,20138,222047,8711370,15199391,1728821,2416341,28055923
overview,United Kingdom,K02000001,2020-10-11,53227,184411,523,21317,259478,8652307,15057187,1726046,2396203,27831743
overview,United Kingdom,K02000001,2020-10-10,67243,188947,1307,24479,281976,8599080,14872776,1725523,2374886,27572265
overview,United Kingdom,K02000001,2020-10-09,74421,202840,5303,20256,302820,8531838,14683829,1724216,2350407,27290290
overview,United Kingdom,K02000001,2020-10-08,72777,198144,4112,15071,290104,8457417,14480989,1718913,2330151,26987470
overview,United Kingdom,K02000001,2020-10-07,77676,160785,4140,16943,259544,8384660,14264515,1714765,2315080,26679020
overview,United Kingdom,K02000001,2020-10-06,76527,163589,4473,21220,265809,8305495,14103730,1710627,2298137,26417989
overview,United Kingdom,K02000001,2020-10-05,58387,174251,3483,40482,276603,8228153,13939698,1706119,2273168,26147138
overview,United Kingdom,K02000001,2020-10-04,53982,169488,1275,26878,251623,8169503,13765447,1702636,2228265,25865851
overview,United Kingdom,K02000001,2020-10-03,63888,189095,1944,33819,288746,8115521,13595959,1701361,2201387,25614228
overview,United Kingdom,K02000001,2020-10-02,72038,177562,6411,20729,276740,8051633,13406864,1699417,2167568,25325482
overview,United Kingdom,K02000001,2020-10-01,70429,168669,5282,27172,271552,7979421,13229302,1692898,2146839,25048460
overview,United Kingdom,K02000001,2020-09-30,77402,156459,5705,22232,261798,7914504,13049925,1687636,2119667,24771732
overview,United Kingdom,K02000001,2020-09-29,69549,141378,5088,21285,237300,7834371,12893466,1681735,2097435,24507007
overview,United Kingdom,K02000001,2020-09-28,57960,140442,3786,29735,231923,7763328,12739860,1676544,2069380,24249112
overview,United Kingdom,K02000001,2020-09-27,56615,170285,1154,39384,267438,7704890,12599418,1672758,2039645,24016711
overview,United Kingdom,K02000001,2020-09-26,66608,167881,2708,23100,260297,7648275,12429133,1671604,2000261,23749273
overview,United Kingdom,K02000001,2020-09-25,73080,185140,6276,34222,298718,7581667,12261252,1668896,1977161,23488976
overview,United Kingdom,K02000001,2020-09-24,73243,172120,6261,23144,274768,7507248,12076112,1662536,1942940,23188836
overview,United Kingdom,K02000001,2020-09-23,78497,153771,6063,31097,269428,7431367,11893836,1656020,1919796,22901019
overview,United Kingdom,K02000001,2020-09-22,71959,146401,5770,22229,246359,7351890,11740065,1649957,1874884,22616796
overview,United Kingdom,K02000001,2020-09-21,58353,130512,4106,25088,218059,7279277,11618072,1644127,1848562,22390038
overview,United Kingdom,K02000001,2020-09-20,55398,164325,994,26382,247099,7220924,11487560,1640021,1823474,22171979
overview,United Kingdom,K02000001,2020-09-19,68993,170892,2538,23274,265697,7165527,11323235,1639027,1797092,21924881
overview,United Kingdom,K02000001,2020-09-18,79167,173342,7808,29594,289911,7096534,11152343,1636489,1773818,21659184
overview,United Kingdom,K02000001,2020-09-17,75947,157252,6647,27448,267294,7016469,10979001,1628603,1744224,21368297
overview,United Kingdom,K02000001,2020-09-16,79465,156754,6339,42738,285296,6939268,10821749,1621817,1716776,21099610
overview,United Kingdom,K02000001,2020-09-15,72641,150505,6370,59306,288822,6856685,10664995,1615478,1674038,20811196
overview,United Kingdom,K02000001,2020-09-14,55037,152681,4666,8808,221192,6782913,10514490,1609108,1614732,20521243
overview,United Kingdom,K02000001,2020-09-13,50178,162995,1172,12730,227075,6727876,10361809,1604347,1597993,20292025
overview,United Kingdom,K02000001,2020-09-12,62516,158650,3043,7760,231969,6677698,10198814,1603175,1585263,20064950
overview,United Kingdom,K02000001,2020-09-11,65672,172968,7895,4304,250839,6615182,10040164,1600132,1577503,19832981
overview,United Kingdom,K02000001,2020-09-10,63735,158713,5858,12006,240312,6548410,9828673,1592107,1573199,19542389
overview,United Kingdom,K02000001,2020-09-09,72385,133274,5893,15913,227465,6484675,9661212,1586249,1561193,19293329
overview,United Kingdom,K02000001,2020-09-08,63688,123163,6184,16574,209609,6411254,9523615,1580356,1545280,19060505
overview,United Kingdom,K02000001,2020-09-07,48888,130364,3797,12643,195692,6346514,9374047,1573945,1528706,18823212
overview,United Kingdom,K02000001,2020-09-06,43098,126832,1256,18788,189974,6297611,9243683,1570154,1514218,18625666
overview,United Kingdom,K02000001,2020-09-05,54511,111608,2807,22662,191588,6254553,9116851,1568893,1491995,18432292
overview,United Kingdom,K02000001,2020-09-04,62040,126743,6780,14900,210463,6200042,9005243,1566086,1469333,18240704
overview,United Kingdom,K02000001,2020-09-03,58914,122445,6579,18945,206883,6138002,8879551,1559306,1454433,18031292
overview,United Kingdom,K02000001,2020-09-02,62197,119575,6078,15371,203221,6078093,8757106,1552662,1435488,17823349
overview,United Kingdom,K02000001,2020-09-01,49760,114598,3995,7334,175687,6015665,8637531,1546584,1420117,17619897
overview,United Kingdom,K02000001,2020-08-31,39267,119287,1420,21960,181934,5966038,8522933,1542589,1412783,17444343
overview,United Kingdom,K02000001,2020-08-30,41083,125788,759,14435,182065,5926771,8403646,1541169,1390823,17262409
overview,United Kingdom,K02000001,2020-08-29,44361,126213,2309,10627,183510,5885688,8277858,1540410,1376388,17080344
overview,United Kingdom,K02000001,2020-08-28,53267,115417,6886,21641,197211,5841327,8151645,1538101,1365761,16896834
overview,United Kingdom,K02000001,2020-08-27,54836,123367,6994,18219,203416,5788060,8035569,1531215,1344120,16698964
overview,United Kingdom,K02000001,2020-08-26,58643,125818,6138,18236,208835,5732837,7900579,1524132,1325901,16483449
overview,United Kingdom,K02000001,2020-08-25,59359,103799,5682,17660,186500,5672807,7774761,1517976,1307665,16273209
overview,United Kingdom,K02000001,2020-08-24,43696,93317,3996,12384,153393,5613279,7649983,1512294,1290005,16065561
overview,United Kingdom,K02000001,2020-08-23,41150,114721,821,18517,175209,5569570,7556666,1508298,1277621,15912155
overview,United Kingdom,K02000001,2020-08-22,49830,121555,3195,6875,181455,5527808,7441945,1507477,1259104,15736334
overview,United Kingdom,K02000001,2020-08-21,56061,124274,7455,3570,191360,5477978,7320390,1504282,1252229,15554879
overview,United Kingdom,K02000001,2020-08-20,55361,115266,6590,6716,183933,5421917,7196116,1496724,1248659,15363416
overview,United Kingdom,K02000001,2020-08-19,59626,116290,5838,8680,190434,5365745,7080850,1488710,1241960,15177265
overview,United Kingdom,K02000001,2020-08-18,59427,93798,5575,4210,163010,5306149,6966008,1482697,1233280,14988134
overview,United Kingdom,K02000001,2020-08-17,44720,95888,3910,5656,150174,5246714,6872210,1477057,1229070,14825051
overview,United Kingdom,K02000001,2020-08-16,42216,120040,1132,5888,169276,5201976,6776322,1473129,1223414,14674841
overview,United Kingdom,K02000001,2020-08-15,52233,122681,2481,5592,182987,5157816,6656282,1472093,1217454,14503645
overview,United Kingdom,K02000001,2020-08-14,53832,113927,6630,3568,177957,5105583,6533601,1469575,1211862,14320621
overview,United Kingdom,K02000001,2020-08-13,54444,104989,6315,4109,169857,5051751,6419674,1462945,1208366,14142736
overview,United Kingdom,K02000001,2020-08-12,58702,109281,6054,10407,184444,4996120,6314685,1456630,1204077,13971512
overview,United Kingdom,K02000001,2020-08-11,56755,90779,5978,12799,166311,4935810,6205404,1450576,1193507,13785297
overview,United Kingdom,K02000001,2020-08-10,44983,90844,3961,24273,164061,4878926,6114625,1444531,1180388,13618470
overview,United Kingdom,K02000001,2020-08-09,43726,109488,1246,11747,166207,4833679,6023445,1440570,1155667,13453361
overview,United Kingdom,K02000001,2020-08-08,49344,97482,2598,15752,165176,4789417,5913957,1439143,1143845,13286362
overview,United Kingdom,K02000001,2020-08-07,54094,102046,5614,20110,181864,4740073,5816475,1436545,1127998,13121091
overview,United Kingdom,K02000001,2020-08-06,59113,103600,6272,16995,185980,4685979,5714429,1430931,1107641,12938980
overview,United Kingdom,K02000001,2020-08-05,59374,93177,6564,15404,174519,4626141,5610829,1424659,1086414,12748043
overview,United Kingdom,K02000001,2020-08-04,56731,84014,6350,16327,163422,4565775,5517652,1418095,1070469,12571991
overview,United Kingdom,K02000001,2020-08-03,44861,78430,4537,30838,158666,4508349,5433638,1411407,1053752,12407146
overview,United Kingdom,K02000001,2020-08-02,44562,79526,1201,38497,163786,4463488,5355208,1406870,1025371,12250937
overview,United Kingdom,K02000001,2020-08-01,46229,84770,2628,28461,162088,4417700,5275682,1405668,976217,12075267
overview,United Kingdom,K02000001,2020-07-31,51120,95882,6893,36325,190220,4371471,5190912,1402811,947756,11912950
overview,United Kingdom,K02000001,2020-07-30,54365,99669,7844,44778,206656,4320354,5095030,1395918,911431,11722733
overview,United Kingdom,K02000001,2020-07-29,55197,88122,7688,14473,165480,4265628,4995361,1388010,866653,11515652
overview,United Kingdom,K02000001,2020-07-28,55096,75515,7128,17207,154946,4210244,4907239,1380320,852180,11349983
overview,United Kingdom,K02000001,2020-07-27,43402,38863,5281,11544,99090,4155149,4831724,1373192,834973,11195038
overview,United Kingdom,K02000001,2020-07-26,40977,63572,1623,7252,113424,4111747,4792861,1367911,823198,11095717
overview,United Kingdom,K02000001,2020-07-25,46013,88032,3107,5802,142954,4068747,4729289,1366023,811877,10975936
overview,United Kingdom,K02000001,2020-07-24,48482,92297,9586,6864,157229,4022736,4641257,1362916,806075,10832984
overview,United Kingdom,K02000001,2020-07-23,51129,83164,9698,8142,152133,3973719,4548960,1353286,799211,10675176
overview,United Kingdom,K02000001,2020-07-22,54435,77027,9391,6742,147595,3922601,4465796,1343588,791069,10523054
overview,United Kingdom,K02000001,2020-07-21,52480,69214,9532,11333,142559,3868166,4388769,1334197,784327,10375459
overview,United Kingdom,K02000001,2020-07-20,43230,40863,7716,9932,101741,3815687,4319555,1324665,772994,10232901
overview,United Kingdom,K02000001,2020-07-19,39747,62825,1720,16676,120968,3771479,4278692,1316883,763062,10130116
overview,United Kingdom,K02000001,2020-07-18,42558,89139,3946,4750,140393,3731733,4215866,1315163,746386,10009148
overview,United Kingdom,K02000001,2020-07-17,49443,107813,12556,7813,177625,3689175,4126728,1311040,741636,9868579
overview,United Kingdom,K02000001,2020-07-16,50434,98781,13777,2974,165966,3639292,4018915,1298484,733823,9690514
overview,United Kingdom,K02000001,2020-07-15,53790,75826,13532,8915,152063,3588561,3920134,1284707,730849,9524251
overview,United Kingdom,K02000001,2020-07-14,53820,58675,13434,6192,132121,3531286,3844308,1271175,721934,9368703
overview,United Kingdom,K02000001,2020-07-13,41340,33420,11241,11402,97403,3477000,3785633,1257311,715742,9235686
overview,United Kingdom,K02000001,2020-07-12,34930,51679,2822,12496,101927,3436603,3752213,1246070,704340,9139226
overview,United Kingdom,K02000001,2020-07-11,46023,78071,8148,2648,134890,3401296,3700534,1243248,691595,9036673
overview,United Kingdom,K02000001,2020-07-10,47258,80867,18619,8120,154864,3355273,3622463,1234887,688947,8901570
overview,United Kingdom,K02000001,2020-07-09,47426,84422,21715,8233,161796,3307912,3541596,1216268,680827,8746603
overview,United Kingdom,K02000001,2020-07-08,51027,69291,22147,10627,153092,3260306,3457174,1194553,672594,8584627
overview,United Kingdom,K02000001,2020-07-07,49319,51370,18050,7499,126238,3209459,3387883,1172356,661928,8431626
overview,United Kingdom,K02000001,2020-07-06,40321,23212,15750,15001,94284,3160140,3336513,1154020,654359,8305032
overview,United Kingdom,K02000001,2020-07-05,37602,39382,3527,16804,97315,3119819,3313301,1138066,639186,8210372
overview,United Kingdom,K02000001,2020-07-04,40466,52707,10282,22645,126100,3081496,3273919,1134075,622187,8111677
overview,United Kingdom,K02000001,2020-07-03,46818,67360,30553,27835,172566,3040901,3221213,1123615,599542,7985271
overview,United Kingdom,K02000001,2020-07-02,46473,65657,27525,29604,169259,2993828,3153853,1092830,571707,7812218
overview,United Kingdom,K02000001,2020-07-01,49258,63378,29401,15094,157131,2947392,3088196,1066325,541918,7643831
overview,United Kingdom,K02000001,2020-06-30,47474,49893,26622,20798,144787,2897765,3024818,1036898,526804,7486285
overview,United Kingdom,K02000001,2020-06-29,39169,23403,22559,20253,105384,2850314,2974925,1010203,496544,7331986
overview,United Kingdom,K02000001,2020-06-28,30656,33797,5928,19848,90229,2808681,2951522,987644,460799,7208646
overview,United Kingdom,K02000001,2020-06-27,40854,50043,14929,11915,117741,2777265,2917725,981256,433568,7109814
overview,United Kingdom,K02000001,2020-06-26,43839,49553,35711,15825,144928,2736411,2867682,966327,421653,6992073
overview,United Kingdom,K02000001,2020-06-25,42153,51020,36438,25565,155176,2692572,2818129,930616,405828,6847145
overview,United Kingdom,K02000001,2020-06-24,43620,44420,36102,16161,140303,2629977,2743980,894195,380263,6648415
overview,United Kingdom,K02000001,2020-06-23,45784,20972,35006,28918,130680,2586357,2699560,857323,364102,6507342
overview,United Kingdom,K02000001,2020-06-22,36984,22958,26084,16931,102957,2540573,2678588,822058,343330,6384549
overview,United Kingdom,K02000001,2020-06-21,29457,27645,9902,9510,76514,2500489,2655630,795915,326398,6278432
overview,United Kingdom,K02000001,2020-06-20,36118,44446,20426,16981,117971,2470849,2627985,786013,316888,6201735
overview,United Kingdom,K02000001,2020-06-19,40640,46551,41155,5189,133535,2434449,2583539,764585,299907,6082480
overview,United Kingdom,K02000001,2020-06-18,41620,44959,44895,4380,135854,2393809,2536988,722961,294718,5948476
overview,United Kingdom,K02000001,2020-06-17,43035,40829,44082,3685,131631,2348319,2492029,678176,290338,5808862
overview,United Kingdom,K02000001,2020-06-16,42540,36422,39895,3578,122435,2305284,2451200,632146,286653,5675283
overview,United Kingdom,K02000001,2020-06-15,35711,32097,28186,5343,101337,2262744,2414778,592204,283075,5552801
overview,United Kingdom,K02000001,2020-06-14,30700,35988,13452,3825,83965,2227033,2382681,562314,277732,5449760
overview,United Kingdom,K02000001,2020-06-13,37983,58061,21337,3028,120409,2195481,2346693,548794,273907,5364875
overview,United Kingdom,K02000001,2020-06-12,40426,54790,46952,4931,147099,2156643,2288632,525020,270879,5241174
overview,United Kingdom,K02000001,2020-06-11,40058,58855,46491,3940,149344,2115412,2233842,477493,265948,5092695
overview,United Kingdom,K02000001,2020-06-10,43200,54652,42979,4678,145509,2074094,2174987,430461,262008,4941550
overview,United Kingdom,K02000001,2020-06-09,43052,48554,37147,4349,133102,2030819,2120335,386984,257330,4795468
overview,United Kingdom,K02000001,2020-06-08,32206,34563,27978,3698,98445,1987767,2071781,349578,252981,4662107
overview,United Kingdom,K02000001,2020-06-07,30792,52998,16694,3638,104122,1955561,2001765,320871,249283,4527480
overview,United Kingdom,K02000001,2020-06-06,35636,54926,22720,4299,117581,1924659,1948767,303264,245645,4422335
overview,United Kingdom,K02000001,2020-06-05,37693,60974,41619,4723,145009,1888571,1893841,280524,241346,4304282
overview,United Kingdom,K02000001,2020-06-04,39593,55852,42899,5880,144224,1849908,1832867,238522,236014,4157311
overview,United Kingdom,K02000001,2020-06-03,39735,56939,40385,6384,143443,1810315,1777015,194467,230134,4011931
overview,United Kingdom,K02000001,2020-06-02,38163,48104,36013,6903,129183,1770451,1720076,155344,223750,3869621
overview,United Kingdom,K02000001,2020-06-01,29998,34765,30357,6451,101571,1731901,1671972,119088,216847,3739808
overview,United Kingdom,K02000001,2020-05-31,27520,47743,23110,7061,105434,1701944,1637207,88731,210396,3638278
overview,United Kingdom,K02000001,2020-05-30,31755,58112,,7520,97387,1674424,1589464,,202450,3466338
overview,United Kingdom,K02000001,2020-05-29,37085,58465,,11002,106552,1642666,1531352,,194930,3368948
overview,United Kingdom,K02000001,2020-05-28,37933,46701,,18100,102734,1605581,1472887,,183928,3262396
overview,United Kingdom,K02000001,2020-05-27,35670,34659,,12685,83014,1567647,1426186,,165828,3159661
overview,United Kingdom,K02000001,2020-05-26,29708,34057,,14334,78099,1531977,1391527,,153141,3076645
overview,United Kingdom,K02000001,2020-05-25,26780,42601,,9097,78478,1502093,1357470,,138807,2998370
overview,United Kingdom,K02000001,2020-05-24,27475,24369,,7789,59633,1475312,1247364,,127256,2849932
overview,United Kingdom,K02000001,2020-05-23,32230,47672,,12410,92312,1447834,1222995,,119467,2790296
overview,United Kingdom,K02000001,2020-05-22,35915,48145,,8083,92143,1415607,1175323,,107057,2697987
overview,United Kingdom,K02000001,2020-05-21,37728,55670,,14521,107919,1379691,1127178,,98974,2605843
overview,United Kingdom,K02000001,2020-05-20,38296,43107,,6416,87819,1341954,1071508,,84453,2497915
overview,United Kingdom,K02000001,2020-05-19,35196,44457,,8473,88126,1303659,1028401,,78037,2410097
overview,United Kingdom,K02000001,2020-05-18,28835,34193,,9504,72532,1273612,987076,,69564,2330252
overview,United Kingdom,K02000001,2020-05-17,24746,50544,,6851,82141,1244725,952883,,60060,2257668
overview,United Kingdom,K02000001,2020-05-16,31549,56713,,5091,93353,1219979,902339,,53209,2175527
overview,United Kingdom,K02000001,2020-05-15,37324,50722,,5888,93934,1188430,845626,,48118,2082174
overview,United Kingdom,K02000001,2020-05-14,32207,49388,,3571,85166,1151107,794904,,40182,1986193
overview,United Kingdom,K02000001,2020-05-13,31828,48885,,2759,83472,1118887,745516,,36611,1901014
overview,United Kingdom,K02000001,2020-05-12,32077,40291,,2491,74859,1086365,696631,,33852,1816848
overview,United Kingdom,K02000001,2020-05-11,25462,41654,,3244,70360,1054288,656340,,31361,1741989
overview,United Kingdom,K02000001,2020-05-10,26327,47214,,3401,76942,1028743,614686,,28117,1671546
overview,United Kingdom,K02000001,2020-05-09,28412,46174,,2616,77202,1002416,567472,,24716,1594604
overview,United Kingdom,K02000001,2020-05-08,32492,42344,,3056,77892,974004,521298,,22100,1517402
overview,United Kingdom,K02000001,2020-05-07,33588,43153,,2171,78912,941508,478954,,19044,1439506
overview,United Kingdom,K02000001,2020-05-06,32667,40610,,1484,74761,907921,435801,,16873,1360595
overview,United Kingdom,K02000001,2020-05-05,32350,33453,,1641,67444,875253,392801,,15389,1283443
overview,United Kingdom,K02000001,2020-05-04,26866,44898,,1304,73068,842903,359348,,18513,1220764
overview,United Kingdom,K02000001,2020-05-03,25867,42336,,614,68817,814140,314450,,12136,1140726
overview,United Kingdom,K02000001,2020-05-02,28052,35507,,0,63559,788273,272114,,11522,1071909
overview,United Kingdom,K02000001,2020-05-01,39095,35047,,751,74893,760219,236607,,11522,1008348
overview,United Kingdom,K02000001,2020-04-30,39753,43390,,1072,84215,721124,201560,,10771,933455
overview,United Kingdom,K02000001,2020-04-29,32150,33493,,1150,66793,681371,158226,,9699,849296
overview,United Kingdom,K02000001,2020-04-28,23648,21615,,242,45505,647084,124733,,8549,780366
overview,United Kingdom,K02000001,2020-04-27,16440,15013,,1834,33287,623435,103118,,8307,734860
overview,United Kingdom,K02000001,2020-04-26,17968,13642,,0,31610,606882,88105,,6473,701460
overview,United Kingdom,K02000001,2020-04-25,17939,11119,,0,29058,588914,74463,,6473,669850
overview,United Kingdom,K02000001,2020-04-24,21981,6244,,535,28760,570975,63344,,6473,640792
overview,United Kingdom,K02000001,2020-04-23,20365,7659,,508,28532,548993,57100,,5938,612031
overview,United Kingdom,K02000001,2020-04-22,20088,2985,,487,23560,528625,49441,,5430,583496
overview,United Kingdom,K02000001,2020-04-21,20063,2700,,51,22814,508536,46456,,4943,559935
overview,United Kingdom,K02000001,2020-04-20,14908,2457,,605,17970,488473,43756,,4892,537121
overview,United Kingdom,K02000001,2020-04-19,13460,5856,,0,19316,455793,41299,,4287,501379
overview,United Kingdom,K02000001,2020-04-18,16460,4789,,377,21626,442333,35443,,4287,482063
overview,United Kingdom,K02000001,2020-04-17,17308,3773,,308,21389,425873,30654,,3910,460437
overview,United Kingdom,K02000001,2020-04-16,17763,3143,,422,21328,408508,26881,,3602,438991
overview,United Kingdom,K02000001,2020-04-15,16166,2323,,176,18665,390731,23738,,3180,417649
overview,United Kingdom,K02000001,2020-04-14,13950,2041,,3,15994,374497,21415,,3004,398916
overview,United Kingdom,K02000001,2020-04-13,12081,2486,,415,14982,360275,19374,,3001,382650
overview,United Kingdom,K02000001,2020-04-12,12017,2489,,0,14506,348193,16888,,2586,367667
overview,United Kingdom,K02000001,2020-04-11,15020,2630,,350,18000,336176,14399,,2399,352974
overview,United Kingdom,K02000001,2020-04-10,15892,1845,,354,18091,321156,11769,,2049,334974
overview,United Kingdom,K02000001,2020-04-09,17188,1655,,273,19116,305217,9924,,1695,316836
overview,United Kingdom,K02000001,2020-04-08,15194,1249,,0,16443,288119,8628,,1422,298169
overview,United Kingdom,K02000001,2020-04-07,13266,1153,,4,14423,272925,7379,,1422,281726
overview,United Kingdom,K02000001,2020-04-06,12858,826,,91,13775,259659,6226,,1418,267303
overview,United Kingdom,K02000001,2020-04-05,11663,1070,,505,13238,246169,5400,,1327,252896
overview,United Kingdom,K02000001,2020-04-04,15103,796,,181,16080,234506,4330,,822,239658
overview,United Kingdom,K02000001,2020-04-03,13616,677,,336,14629,219403,3534,,641,223578
overview,United Kingdom,K02000001,2020-04-02,12854,603,,166,13623,179190,2857,,305,182352
overview,United Kingdom,K02000001,2020-04-01,11256,668,,23,11947,164844,2254,,139,167237
overview,United Kingdom,K02000001,2020-03-31,11267,629,,,11896,153588,1586,,,155174
